1111111111111111111111111111111111  
1E000000000000C00000C0000000000001
1010010100100000101001000000010101
1010010010101010001001000000010101
1000000P00C00C000000000000000000C1
1111111111111111111111111111111111