1111111111111111111111111111111111
1000000000C0000000000000000C000001
1010010100000C00101001000000010101
1010010010101010001001000000010101
10P000000000000C0000000000000000E1
1111111111111111111111111111111111