1111111111111111111111111111111111
10E00000P0000000C00000C00000000001
1010010100000000101001000000010101
1010010010101010001001000000010101
10P000000C00C0000000000000000000C1
1111111111111111111111111111111111