11111111111111
1E0000C0000001
11000000C00001
1000C000000001
11111C00000001
11110P000000C1
11111111111111