11111111111111
1E000000000C01
10000000C00001
11111110000001
11111C00000001
11110P000000C1
11111111111111